Air TV OST - Natsukage -summer lights- guitar cover (solo)
Alan Walker - All Falls Down (Fingerstyle Guitar Cover)-1XfdURNeY6s
(Alan Walker) Faded - Fingerstyle Guitar Cover (with TABS)-44FPny8k4DM
 A Salty Dog  - PROCOL HARUM -  Acoustic Solo Fingerstyle Guitar Cover by Fabrizio Pieraccini
Avenged Sevenfold - Seize The Day [FINGERSTYLE GUITAR] Cover Acoustic Guitar solo
Az Úr van itt - Albert Gyorfi ( Solo Acoustic Guitar Cover )
Bohemian Rhapsody (Queen) - Acoustic Guitar Solo Cover Fingerstyle-9sYVHOsxdEA
Bullet for my valentine - Tears dont fall acoustic guitar cover
Channing Tatums Guitar Solo - The Vow Guitar Cover by Jose Osorio
Charlie Puth - Attention - Cover (Fingerstyle Guitar) #bestcoverever contest-9ygrq7in_uI
COWBOY BEBOP Waltz for Zizi acoustic guitar solo
Despacito - Luis Fonsi, Daddy Yankee ft. Justin Bieber - Cover (Fingerstyle Guitar)-8YELO9yxs_c
DESPACITO - Luis Fonsi ft. Daddy Yankee (Nathan Fingerstyle _ Guitar Cover)-7SPnwtQkUb4
(Elvis Presley) Can't Help Falling In Love - Fingerstyle Guitar Cover (with TABS)-IPsA3sz934M
Fairy Tail - Main Theme Slow Version guitar cover (solo)
(Frozen OST) Let It Go - Sungha Jung-AAnID4RS7Vg
Georgia On My Mind (Ray Charles _ Hoagy Carmichael) - Fingerstyle Acoustic Guitar Cover-5W0OTX18wG0
Guilty Crown OST - Release My Soul guitar cover (solo)
[Guitar solo fingerstyle] Spectre - Alan Walker-XYizxH7yAqA
Intan Ku Kesepian (Wings) - Instrumental - Acoustic Guitar - Cover
I Will - Chelsy - Ao Haru Ride OST (Solo Guitar Cover)
Jimmy Page Style - Open C Acoustic Guitar Solo - by  Sergio Rivas
Johnny Be Goode (Chuck Berry) - Acoustic Guitar Solo Cover Fingerstyle-HaX5E66eW24
(Justin Bieber) Purpose - Fingerstyle Guitar Cover (with TABS)-At63FPRHLAo
Justin Bieber - Sorry - Fingerstyle Guitar Cover by James Bartholomew-86hnEemgPPw
Keith Getty - In Christ Alone - Solo Guitar Cover - Paul Adrian Moldez
Kimi ni Todoke 1st Season ED - Kataomoi guitar cover (solo)
Metallica - Fade To Black [acoustic guitar cover]-0H7Q1Env4UY
Metallica - The Unforgiven [FINGERSTYLE GUITAR] Cover Acoustic Guitar solo
NOVEMBER RAIN (Guns n' Roses) - Acoustic Guitar Solo Cover-1E7U1w2Z8C0
November Rain - Guns N' Roses [FINGERSTYLE GUITAR] Acoustic Guitar solo cover-3AQsq1PG1Wc
Numb - Linkin Park (acoustic guitar cover)-DeQHA0xP2zk
Panama - Matteo Fingerstyle Guitar Cover by Toeyguitaree (Tab)
Pirates of the Caribbean Theme on Acoustic Guitar
Popular Song`s 1960 2015 Guitar Cover Acoustic Fingerstyle
Rocket Man - Acoustic Guitar - Elton John--8AgRz5Jdrw
Seven Nation Army - Acoustic Guitar Solo Cover Fingerstyle)-1OsOEt5Qpfc
(Shawn Mendes) Treat You Better - Fingerstyle Guitar Cover (with TABS)-MVZGmcXU2D8
Shimotsuki Haruka - Inori no Tane guitar cover (solo)
Summertime (George Gershwin) - Fingerstyle Acoustic Guitar Cover-40KRN9rzkpk
Sword Art Online ED - Yume Sekai guitar cover (solo)
Sword Art Online II ED 1 - Startear guitar cover (solo)
Symphony - Clean Bandit ft. Zara Larsson - Cover (Fingerstyle Guitar)-XdoR3Mw217M
Teenage Dirtbag - Wheatus - Solo Guitar Cover by James Bartholomew
Teremts bennem tiszta szívet - Albert Gyorfi ( Solo Acoustic Guitar Cover )
(The Beatles) Here Comes The Sun - Gabriella Quevedo-HGlIImajcRI
The Best of Michael Jackson - Acoustic Guitar Solo cover (Violão Fingerstyle)
The Godfather Theme (Movie - Slash) - Acoustic Guitar Solo Cover (Violão Fingerstyle)
The House of the Rising Sun - Solo Guitar Cover
Toto - Africa -  Acoustic Guitar Cover Fingerstyle-7_eFPuFPfR4
หน้าหนาวที่แล้ว - TOYS Fingerstyle Guitar Cover by Toeyguitaree (TAB)
W A Mozart - Rondo alla Turca (Turkish March) solo classical guitar
When You're Gone - Avril Lavigne - Solo Acoustic Guitar Cover by James Bartholomew-7zrsesZWrhc
(Zara Larsson) Uncover - Fingerstyle Guitar Cover (with TABS)-TzbeCt4_LFc
Zombie  - The Cranberries - Igor Presnyakov - acoustic fingerstyle guitar cover-A0vpsRipL7c
一週間フレンズ Isshuukan Friends ED - Kanade (奏) acoustic guitar fingerstyle solo
山下達郎『クリスマス・イブ』 (Fingerstyle Guitar)  Yuki Matsui
李榮浩-李白(acoustic guitar solo)
林俊傑-可惜沒如果(acoustic guitar solo)
那英 - 默 (acoustic guitar solo)
